1111111111111111111111111111111111111111
1000C000000C0000000000000000C0000C000001
1011000111111110001111100001111000111101
1C10C00000C000000CCC000000C0000000C00101
1010111110111111111111111111110011010101
101C100000111111111111111111110C100101C1
1C101C1010111111100111000011110010C1C101
101010101C11111100111000000111C010010101
10101C101011111001110011100111001C01C1C1
1010101010111100111100111001110010010101
1000100010111000000001110011110CC0010001
1P001000101100000011111001111100100100E1
100000101C11111001111001111111C0100C0001
1010101010111100111100000001110010C101C1
1010101010111001111000000001110010010101
1C1010100C111111111111111111110000010101
101010101011111111111111111111C1111101C1
101000000C000000000CCC000000C0000C000101
1C11111110001111111001111111000111111101
10000C0000000000C000000CCC0000000C000C01
1111111111111111111111111111111111111111