1111111
10C0111
1110111
1C00EC1
1PCC111
1111111

