1111111111111111111111111111111111111111
1E0010000000000C00000C000000001000000001
1010101111111110001111111110111111001001
1010100000100000000000000000000001001001
1P0000010C10C0000000000011111100C0000001
1111010100100100000000000010000001011111
100001010010010001111111001000000100C001
1011010100100100010000010011100001011101
10110101001001000101110100001000010C0001
1000010100000100000111000000100001111111
1111110100000100010111010111100000000001
1000000000000100010000010000100000000001
1010000000001111111111110000111111111001
1010000100000000000000000000000000000001
1010000100000000000001000001000001111001
1010000111111111001001000001000001000001
1000000000000001001001111111111111001001
1011111111001001001001000001000001001001
1010000000001001001001001111111100001001
1000000000000000000000000000000001000001
1111111111111111111111111111111111111111